3
bar
50
50
11111111111111111111111111111111111111111111111111
10000000000000000000000400040000004040000000000001
10000770000000000000000033300000003334000000000001
10000770000000000000000400040000004040000000000001
10000770004340000000000000000000000000000000000001
10000000000300000000000000000000000000000019100001
10000000004300000000000000000000000000000019104341
10000000000040077000000000000000000000000019100301
10000000000000077000000000000000000000000019104341
17770000000000000000000000000000000000000019100001
10070000000000000000000000000000000000000019100001
10070000000000000040400000004334000000000011100001
10070000000000000033300000004334000000000000000001
10070000040040000400040000000000000000000000043401
10070000003300000000000000000000000000000000003001
10070000003300000000000000040040000000000000040401
10070000040040000000000000003300000000000011111111
10070000000000000000000000003340000000040419999999
10070000000000000000000000040000000000433319999999
10070000000000000000000000000000000000433319999999
10077777700000000000000000000000000000040419999999
10077777700000000000000000000000000000000019999999
11111111111111111111111111111111122111111111111111
10000000000000000000000000000000000000000000000002
20000000000000000000000000000000000000000000000002
10000000000000000000000000000000000000000000000002
10000000000000000000000000000000000000000000000002
10000000000000000000000000000000000000000000000002
11111111111111111111111111111111111111111111111111
99999999999999999999999999999999999999999999999999
99999999999999999999999999999999999999999999999999
99999999999999999999999999999999999999999999999999
99999999999999999999999999999999999999999999999999
99999999999999999999999999999999999999999999999999
99999999999999999999999999999999999999999999999999
99999999999999999999999999999999999999999999999999
99999999999999999999999999999999999999999999999999
99999999999999999999999999999999999999999999999999
99999999999999999999999999999999999999999999999999
99999999999999999999999999999999999999999999999999
99999999999999999999999999999999999999999999999999
99999999999999999999999999999999999999999999999999
99999999999999999999999999999999999999999999999999
99999999999999999999999999999999999999999999999999
99999999999999999999999999999999999999999999999999
99999999999999999999999999999999999999999999999999
99999999999999999999999999999999999999999999999999
99999999999999999999999999999999999999999999999999
99999999999999999999999999999999999999999999999999
99999999999999999999999999999999999999999999999999
hall biblio
50
50
11111111111111111111111111111111199999999999999999
13488884388438884388843888888888199999999999999999
13488884388438884388843888888888199999999999999999
13488884388438884388843888888888199999999999999999
13488884388438884388843888888888199999999999999999
13488884388438884388843888888888199999999999999999
18888888888888888888888888888888199999999999999999
18888888888888888888888888844888199999999999999999
18888888888888888888888888433488199999999999999999
13488884388438884388843888433488199999999999999999
13488884388438884388843888844888199999999999999999
13488884388438884388843888888888199999999999999999
13488884388438884388843888888888199999999999999999
13488884388438884388843888888888199999999999999999
11111111111111001111111188887777199999999999999999
99999999999991000000111188887000199999999999999999
99999999999991000000000188887000199999999999999999
99999999999991000000000188887000199999999999999999
99999999999991000000111188881111111111111111111111
99999999999991000000111111111000000000000000000001
99999999999991000000111111111000000000000000000001
99999999999991000000111111111000000000000000000001
99999999999991000000111111111000000000000000000001
99999999999991000000111111111000000000000000000001
11111111111111000000111111111000000000000000000001
20000000000000000000000000000000000000000000000001
20000000000000000000000000000000000000000000000002
20000000000000000000000000000000000000000000000002
20000000000000000000000000000000000000000000000002
20000000000000000000000000000000000000000000000001
11111111111111111111111111111000000000000000000001
99999999999999999999999999991000000000000000000001
99999999999999999999999999991000000000000000000001
99999999999999999999999999991000000000000000000001
99999999999999999999999999991000000000000000000001
99999999999999999999999999991000000000000000000001
99999999999999999999999999991000000000000000000001
99999999999999999999999999991000000000000000000001
99999999999999999999999999991000000000000000000001
99999999999999999999999999991000000000000000000001
99999999999999999999999999991000000000000000000001
99999999999999999999999999991000000000000000000001
99999999999999999999999999991000000000000000000001
99999999999999999999999999991000000000000000000001
99999999999999999999999999991000000000000000000001
99999999999999999999999999991000000000000000000001
99999999999999999999999999991000000000000000000001
99999999999999999999999999991000000000000000000001
99999999999999999999999999991000000000000000000001
99999999999999999999999999991111111111111111111111
