4
bar
20
20
11111111111111111111
10000000000000000001
10000004000400000001
10000000333000000001
10000004000400000001
10040000000004000401
10003330000000333001
10040004000000400401
10000000000000000001
10040004000000000001
10003330000004004001
10040004000000333001
10000000000004004001
10000000000000000001
10000000000000000001
11111111001111111111
10000000000000000001
10000000000000000002
10000000000000000002
11111111111111111111
biblio
20
20
11111111111111111111
18888888888888888881
13488834834834888431
13888838838838888831
13488834834834888431
18888888888888888831
18888888888888888431
18888888888888888831
13488834834834888431
13888838838834888831
13488834834834888431
18888888888888888881
11111111111188888881
19999991000088888881
19999991000088888881
11111111000111111111
10000000000000000001
20000000000000000002
20000000000000000002
11111111111111111111
hall
20
20
11111111111111111111
10000000000004000001
10000000000000000401
10333044000000333001
10333000000000333001
10000000000000000001
10000000000000000001
10000000000000000001
10000000000000000001
10000000000000000001
10000000000000000001
10000000000000000001
10000000000000000001
10000000000000000001
10000000000000000001
10000000000000000001
10000000000000000001
20000000000000000002
20000000000000000002
11111111111111111111
SUM
20
20
11111111111111111111
10004040000404000051
10003330000033340001
10000000000400000001
10000000000000000001
10000000000000000001
10004040000400040001
15003330000033300001
10003330000033300001
10004004000400040001
10000000000000000001
10000000000000000001
10000000000000000001
10000000000000000001
10000000111111111111
10000000000000000001
10000000004004000001
20000000000333000051
20000000004000400001
11111111111111111111

